00000000000000000000
00000011111100000000
00001110000011100000
00011000000000110000
00011000000000011000
01100000000000001100
01100011000011000110
11000011000011000011
11000000000000000011
11000000000000000011
11000000000000000011
11000100000000100011
01100011111111000110
01100000000000001100
00011000000000011000
00001100000000110000
00000111000011100000
00000000111100000000
00000000000000000000
00000000000000000000
