00000000000000000000
09020105040600000000
09020105040600000000
09020105040600000000
09020105040600000000
09020105040600000000
00000000000000000000
00000000000000000000
00000000000000000000
00055001100220099000
00055001100220099000
00000000000000000000
00000000000000000000
00044006600000000000
00044006600000000000
00000000000000000000
00000000000000000000
00000000000000000000
00000000000000000000
00000000000000000000
